34 113
#################################################################################################################
#################################################################################################################
#################################################################################################################
#################################################################################################################
#################################################################################################################
#################################################################################################################
#################################################################################################################
#####################################################################                                          /#
#####################################################################_________________________________________/ #
#####################################################################                                           #
####################################################################*                                           #
#####################################################################                                           *
#####################################################################                                           #
#####################################################################                                           #
#####################################################################                                           #
#####################################################################                                          /#
###############################################################################################      ############
####################################################*##########################################      ############
##################################        /                  /                            /###*      ############
##################################_______/                  /___________________________ / ####      ############
*             |__o__|            /                                 ______________________| ####____  ############
#############  (   ) __________ /                                ;|                        ####    |;############
#############  (   )                                             ;| Bathroom is where your #### is |:############
#############   \_/                                              ;|                        ####____|:############
#############               ___                                  ;|_______________________ ######################
#############              ( o )                                                         | ######################
#################################################################################################################
#################################################################################################################
#################################################################################################################
#################################################################################################################
#################################################################################################################
#################################################################################################################
#################################################################################################################
#################################################################################################################