34 113
#################################################################################################################
#################################################################################################################
#################################################################################################################
#################################################################################################################
#################################################################################################################
#################################################################################################################
#################################################################################################################
####################################################################|                                          /|
####################################################################|_________________________________________/ |
####################################################################|                                           |
####################################################################*                                           *
####################################################################|                                           |
####################################################################|                                           |
####################################################################|                                           |
####################################################################|                                           |
####################################################################|                                          /#
###############################################################################################      ############
###########################################________*__________#################################      ############
##################################        /                  /                            /####      ############
##################################_______/                  /___________________________ / ####      ############
*           # |__o__|            /                                 ____________________  | ####      ############
#############  (   ) __________ /                                ;|                   /  | ####      ############
#############  (   )                                             ;| Bathroom is where/   | ####      ############
#############   \_/                                              ;|                 /    | ####      ############
#############               ___                                  ;|________________/     | ######################
#############              ( o )                                                         | ######################
#################################################################################################################
#################################################################################################################
#################################################################################################################
#################################################################################################################
#################################################################################################################
#################################################################################################################
#################################################################################################################
#################################################################################################################