34 113
#################################################################################################################
#################################################################################################################
#################################################################################################################
#################################################################################################################
#################################################################################################################
#################################################################################################################
#################################################################################################################
####################################################################|                                          /|
####################################################################|_________________________________________/ |
####################################################################|                                           |
####################################################################*                                           *
####################################################################|                                           |
####################################################################|                                           |
####################################################################|                                           |
####################################################################|                                           |
####################################################################|                                          /|
##############################################################################################|      ############
###########################################________*__________################################|      ############
##################################        /                  /                            /###*      ############
##################################_______/                  /___________________________ / ###|      ############
*             |__o__|            /                                 ______________________| ###|____  ############
#############  (   ) __________ /                                ;|                        ####    |;############
#############  (   )                                             ;| Bathroom is where your #### is |:############
#############   \_/                                              ;|                        ####____|:############
#############               ___                                  ;|_______________________ ######################
#############              ( o )                                                         | ######################
#################################################################################################################
#################################################################################################################
#################################################################################################################
#################################################################################################################
#################################################################################################################
#################################################################################################################
#################################################################################################################
#################################################################################################################