34 113
____________________*____________________________________________________________________________________________
|                                     # # ##                                                                    |
|______________________________________#__________________                                                      |
/                                                          \          ________________________________________  |
|                                                          |\       /|       |                               |  |
|           _____          ___________________             | \     / |       |                               |  |
|          /_____\         |        |        |             |  \    | |       |                               |  |
|           /              |  """"  |  """"  |             |   |   | |       |            /                  |  |
|         //  |   \        |  """"  |  """"  |             |   |   | |       |           /                   |  |
|     ___ /_               |  """"  |  """"  |             |   |   | |       |          /                    |  |
|    (   /  ))             |   ""   |  """   |             |   |   | |       |                               |  |
|    (______))             ───────────────────             |   |   | |_______|_______________________________|  |
___________________________________________________________|   |   |/_______________________________________/   #
|\_________________________________________#__#____________ \  |   /___________________ / | /             / |   *
| \________\ |                # #  ##_#/  #    #           \ \ |                          |/_____________/  |   #
|  \________\|#        #    #  /####/ \###  #               \_\|                                            |   |
|  |                           \###/   \######  #      #                                                    |   |
|  |    #   #          #      ### / o o \###_##_                  !                                         |   |
|                                (       )#)# # #             !          !             !                    |   |
|                        #  ##  ##\  -  /####  #  #                !              !                         |   |
|  |# #   #   #     #     ###### ##\   /###  #      #                    !                                  |   |
|  |   #        #       ##  #### # #\_/  ###               #                                                |  /#
| #|  #    # # #   #   #      #  ##  #  ## # # #     #                        ___________________           | / #
|  | #          #       #      ### # ##  # #  #                               |             |   /           |/__#
#\ |                         #      #                      #                  | Bedroom is w|  /                #
#_\|                                                                          |      your dr| /                 #
#                                                                             |_____________|/                  *
*                                                                                                               #
#                                                                  ____________________                      ___#
#                                                                 /                     \                   |\  #
|\                                                               /                       \    ______________| \ #
| \                                                             /                         \  |\______________\ \#
|  |                                                           /__________________________ \ | \              \ |
______________________________________________________________|_____________________________|| |_______________\|