▓▓▓▓▓▓▓▓▓▓▓▓▓▓▓▓▓▓▓▓*▓▓▓▓▓▓▓▓▓▓▓▓▓▓▓▓▓▓▓▓▓▓▓▓▓▓▓▓▓▓▓▓▓▓▓▓▓▓▓▓▓▓▓▓▓▓▓▓▓▓▓▓▓▓▓▓▓▓▓▓▓▓▓▓▓▓▓▓▓▓▓▓▓▓▓▓▓▓▓▓▓▓▓▓▓▓▓▓▓▓▓▓
▓                      /     /                                                                                  ▓
▓     ___________/ \  /_____/___ __  /     <----Papers on the floor                                             ▓
▓     |||           / | | CiReL    |/                                                                           ▓
▓     ||| EDAT.qw  / /||  Stuff    |                                                                            ▓
▓     |||    g   \/ / |||______ ___|                                                                            ▓
▓     |||         \\\________|   /                                                                              ▓
▓     |||_______ __| /      /   /                                                                               ▓
▓    /            __/  ___     /                                                                                ▓
▓   /_________  /     /______ /                                                                                 ▓
▓             |/__/__/                                                                                          ▓
▓_________________________________________________________                                                      ▓
/                                                          \          ________________________________________  ▓
|                          __________________              |\       /|       |                               |  ▓
|                          |        |        |\            |  \    | |       |                               |  ▓
|                          |  """"  |  """"  ||\           |   |   | |       |            /                  |  ▓
|_____                     |  """"  |  """"  |||           |   |   | |       |           /                   |  ▓
|     \                    |  """"  |  """"  |||           |   |   | |       |          /                    |  ▓
|      \__                 |________|________|||           |   |   | |       |                               |  ▓
|         |_____            \_________________\|           |   |   | |_______|_______________________________|  ▓
________________\____________\_________________\___________|   |   |/_______________________________________/   ▓
▓\_______________|_________________________________________ \  |   /___________________ / | /             / |   ▓
▓ \________\ |    \                                        \ \ |                          |/_____________/  |   ▓
▓  \________\|     \_                                       \_\|                                            |   ▓
▓  |                 \_                                                                                     |   ▓
▓  |               ____\                                                                                    |   ▓
▓  |            __/|   |\____                                                                               |   ▓
▓  |            | ||___| | |t                                                                               |   ▓
▓  |            |_/_____\|_|t                                      _____________________                    |   ▓
▓  |            | 123  TELE t                                     /                     \                   |   ▓
▓\ |            | 456  TELE t                                    /                       \    ______________|   ▓
▓ \|            | 789  TELE t                                   /                         \  |\______________\  ▓
▓  |            | #0- PHONE t                                     _________________   ____ \ | \                ▓
▓▓▓▓▓▓▓▓▓▓▓▓▓▓▓▓▓▓▓▓▓▓▓▓▓▓▓▓▓▓▓▓*▓▓▓▓▓▓▓▓▓▓▓▓▓▓▓▓▓▓▓▓▓▓▓▓▓▓▓▓▓|____________________▓*▓______|| |__▓*▓__________\▓