▓▓▓▓▓▓▓▓▓******************▓▓▓▓|______________________________|_____________________________|▓▓|______________ /▓
▓\       \  |              \    \      /                      |_____________________________|| |______________/ ▓
▓ \     ░ \ |     ░      ░  ░__░░\░  ░ \   ░  ░                \           !               / | /             /  ▓
▓  \_______\|                ░░ ░░░░░_░/  ░    ░                \  !                 !    /  |/_____________/   ▓
▓  |     ░    ░        ░    ░  /░░░░/ \░░░  ░____________________\    ! /   |   \        /                  |   ▓
▓  |░      ░                   \░░░/   \░░░░░░  ░      ░          \_____________________/     !             |   ▓
▓  | ░  ░░░ ░          ░      ░░░ / o o \░░░_░░_                  !                                         |   ▓
▓░░|  ░░     ░   ░ Old Simone -> (       )░)░ ░ ░             !          !             !                    |   ▓
▓  ░ ░   ░  ░░ ░   ░  ░ ░░  ░░  ░░\  -  /░░░░  ░  ░                !              !                         |   ▓
▓  |░ ░   ░   ░ ░░░ ░░░░  ░░░░░░ ░░\   /░░░  ░      ░                    !                                  |   ▓
▓  |   ░ ░ ░░   ░   ░   ░░  ░░░░ ░ ░\_/  ░░░               ░                                                |   ▓
▓ ░|  ░    ░ ░ ░   ░   ░      ░  ░░  ░  ░░ ░ ░ ░     ░                                                      |   ▓
▓  | ░          ░       ░      ░░░ ░ ░░  ░ ░  ░                                                             |   ▓
*\ |                         ░      ░                      ░                                                |  /*
*_\|                                         ░                                                              | / *
*                                  ░                                         _____________________          |/__*
*                                                                           |                     |             *
*                                                                           |  Bedroom is where   |             *
*                                                                           |                     |             *
▓\                                                                          |     your dreams are |           /▓
▓ \                                                                         |_____________________|           / ▓
▓ |                                                                                                          /  ▓
▓ |                                                                                                         |   ▓
▓__________________________________________________________                                                 |   ▓
/                                                          \          ______________________________________|_  ▓
|                                                          |\       /|       |                               |  ▓
|           _____                                          ||      / |       |                               |  ▓
|          /_____\              / \ ___                    ||      | |       |                               |  ▓
|           /                  /   \  |                    ||      | |       |            /                  |  ▓
|         //  |   \             \   \ |                    ||      | |       |           /                   |  ▓
|     ___ /_                     \   \|                    ||      | |       |          /                    |  ▓
|    (   /  ))                    \___\                    ||      | |       |                               |  ▓
|    (______))                                             ||      | |_______|______________________________ |  ▓
|▓▓▓▓▓▓▓▓▓▓▓▓▓▓▓▓▓▓▓▓▓▓▓▓▓▓▓▓▓▓▓▓▓▓▓▓▓▓▓▓▓▓▓▓▓▓▓▓▓▓▓▓▓▓▓▓▓▓||******|/________/_______________________________|▓▓▓