▓▓▓▓▓▓▓▓▓▓▓▓*****************▓▓▓▓▓▓▓▓▓▓▓▓▓▓▓▓▓▓▓▓▓▓▓▓▓▓▓▓▓▓▓▓▓▓▓▓▓▓▓▓▓▓▓▓▓▓▓▓▓▓▓▓▓▓▓▓▓▓▓▓▓▓▓▓▓▓▓▓▓▓▓▓▓▓▓▓▓▓▓▓▓▓▓▓
▓                                     ░ ░ ░░                                                                    ▓
▓______________________________________░__________________                                                      ▓
/                                                          \          ________________________________________  ▓
|                                                          |\       /|       |                               |  ▓
|           _____          ___________________             | \     / |       |                               |  ▓
|          /_____\         |        |        |             |  \    | |       |                               |  ▓
|           /              |  """"  |  """"  |             |   |   | |       |            /                  |  ▓
|         //  |   \        |  """"  |  """"  |             |   |   | |       |           /                   |  ▓
|     ___ /_               |  """"  |  """"  |             |   |   | |       |          /                    |  ▓
|    (   /  ))             |   ""   |  """   |             |   |   | |       |                               |  ▓
|    (______))             ───────────────────             |   |   | |_______|_______________________________|  *
___________________________________________________________|   |   |/_______________________________________/   *
▓\_________________________________________░__░____________ \  |   /___________________ / | /             / |   *
▓ \________\ |                ░ ░  ░░_░/  ░    ░           \ \ |                          |/_____________/  |   *
▓  \________\|░        ░    ░  /░░░░/ \░░░  ░               \_\|                                            |   *
▓  |                           \░░░/   \░░░░░░  ░      ░                                                    |   ▓
▓  |    ░   ░          ░      ░░░ / o o \░░░_░░_                  !                                         |   ▓
▓                                (       )░)░ ░ ░             !          !             !                    |   ▓
▓                        ░  ░░  ░░\  -  /░░░░  ░  ░                !              !                         |   ▓
▓  |░ ░   ░   ░     ░     ░░░░░░ ░░\   /░░░  ░      ░                    !                                  |   ▓
▓  |   ░        ░       ░░  ░░░░ ░ ░\_/  ░░░               ░                                                |   ▓
▓ ░|  ░    ░ ░ ░   ░   ░      ░  ░░  ░  ░░ ░ ░ ░     ░                        ___________________           |   ▓
▓  | ░          ░       ░      ░░░ ░ ░░  ░ ░  ░                               |             |   /           |___▓
*\ |                         ░      ░                      ░                  | Bedroom is w|  /                *
*_\|                                                                          |      your dr| /                 *
*                                                                             |_____________|/                  *
*                                                                                                               *
*                                                                  ____________________                      ___*
*                                                                 /                     \                   |   ▓
▓\                                                               /                       \    ______________|   ▓
▓ \                                                             /                         \  |\______________\  ▓
▓  |                                                           /__________________________ \ | \              \ ▓
▓▓▓▓▓▓▓▓▓▓▓▓▓▓▓▓▓▓▓▓▓▓▓▓▓▓***************▓▓▓▓▓▓▓▓▓▓▓▓▓▓▓▓▓▓▓▓▓|_____________________________|| |_______________\▓