34 113
#################################################################################################################
#################################################################################################################
#################################################################################################################
#################################################################################################################
#################################################################################################################
#################################################################################################################
#################################################################################################################
#####################################################################                                          /#
#####################################################################_________________________________________/ #
#####################################################################                                           #
#                                /###################################                                           *
#_______________________________/ ###################################                                           #
#                              |  ###################################                                           #
#                              |  ###################################                                           #
*                              |  ###################################                                           #
#                              |  ###################################                                          /#
#                              |  ###################################                     /######################
#                              |  ##################*################                    / ######################
#                              | /        /                  /      /                    | ######################
#                              |/________/                  /______/                     | ######################
#                                                                                        | ######################
#############                                                                            | ######################
#############                                                                            | ######################
#############                                                                            | ######################
#############                                                                            | ######################
#############                                                                            | ######################
####################################################*############################################################
#################################################################################################################
#################################################################################################################
#################################################################################################################
#################################################################################################################
#################################################################################################################
#################################################################################################################
#################################################################################################################