                                  /##############################################################################
                                 / ##############################################################################
                                /  ##############################################################################
                               /   ##############################################################################
                              /    ##############################################################################
                             /     ##############################################################################
                            /     /############################################################################## 
                           /     / ##############################################################################
           _____________________/__##############################################################################
          |                     |  ##############################################################################
          |                     |  ##############################################################################
          |                     |  ##############################################################################
          |                     |  ##############################################################################
          |                     |  #################*############################################################
          |                     | /      /                    /                                                /#
          |                      /_____ /                    /________________________________________________//#
          |                                                                                                  |/ #
          |                                                                                                     #
          |                                                                                                     #
          |                                                                                                     *
          |                      _______                     ________________________________________________|\ #
          |                     |\      \                    \                                                \\#
          |                     | \      \                    \                                                \#
          |                     |  #################*############################################################
          |                     |  ############################################################################## 
          |                     |  ##############################################################################
          |                     |  ##############################################################################
          |_____________________|__##############################################################################
                             \   \ ##############################################################################
                              \   \##############################################################################
                               \   ##############################################################################
                                \  ##############################################################################
                                 \ ##############################################################################
                                  \##############################################################################