▓▓▓▓▓▓▓▓▓▓▓▓▓▓▓▓▓▓▓▓▓▓▓▓▓▓▓▓▓▓▓▓▓▓▓▓▓▓▓************************▓▓▓▓▓▓▓▓▓▓▓▓▓▓▓▓▓▓▓▓▓▓▓▓▓▓▓▓▓▓▓▓▓▓▓▓▓▓▓▓▓▓▓▓▓▓▓▓▓
▓                                 /▓▓▓/                       //▓▓▓             |                              ▓
▓________________________________/ ▓▓▓                       // ▓▓▓_____________|         Floor 1997           ▓    
▓      (()              (()     | /  /                       | /  /             |                              ▓
▓     ((  )            ((  )    |/__/                        |/__/              |_____________________________ ▓
▓    ((    )            (()                                                                                  | ▓
*     ((  )                                                                                                  | ▓
*      (()                                                                                                   | ▓
*                                                                                                            | ▓
*                                                                                                            | ▓
▓                                                                                                            | ▓
▓                                                                                                            | ▓
▓▓▓▓▓▓▓▓▓▓                                                          (()                              /▓▓▓▓▓▓▓▓▓▓
▓▓▓▓▓▓▓▓▓▓                                                         ((  )                            / ▓▓▓▓▓▓▓▓▓▓
▓▓▓▓▓▓▓▓▓▓                                                          (()                            |  ▓▓▓▓▓▓▓▓▓▓
▓▓▓▓▓▓▓▓▓▓                                                                                         |  ▓▓▓▓▓▓▓▓▓▓
▓▓▓▓▓▓▓▓▓▓                                                                                         |  ▓▓▓▓▓▓▓▓▓▓
▓        /                                                                                         | /        /▓
▓_______/                                                                                          |/________/ ▓
▓                                                                                                            | ▓
▓                                                                                                            |_▓
▓----------------------------------------------------------------------------------                          | ▓
▓____________________________________________________________________________                    NOTICE:     | *
▓    |        |        |        |                                           /|                  Elevator is  | *
▓    |        |        |        |                                   _______/ |                  out of order | *
▓    |        |        |        |                                  /|      | |                               | *
▓    |        |        |        |                          _______/ |      | |                 Please use the| *
▓    |        |        |        |                         /|      | |      | |                     stairs.   | *
▓    |        |        |        |                 _______/ |      | |      | |                               | *
▓    |        |        |        |                /|      | |      | |      | |                               |_▓
▓    |        |        |        |         ______/ |      | |      | |      | |                               | ▓
▓    |        |        |        |       /|      | |      | |      | |      | |                               | ▓
▓▓▓▓▓▓▓▓▓▓▓▓▓▓▓▓▓▓▓▓▓▓▓▓▓▓▓▓▓▓▓▓▓▓▓▓▓▓▓▓▓▓▓▓▓▓▓▓▓▓▓▓▓▓▓▓▓▓▓▓▓▓▓▓▓▓▓▓▓▓▓▓▓▓▓▓▓▓▓▓▓▓▓▓▓▓▓▓▓▓▓▓▓▓▓▓▓▓▓▓▓▓▓▓▓▓▓▓▓▓▓▓