34 113
#################################################################################################################
#                  //    |             |                         |                            |                /#
#_________________| |    |_____________|_________________________|____________________________|______________ / #
#                 | |    /____________/_________________________/____________________________/                | #
#                 | |    |            |                         |                            |                | #
#                 | |    |            |                         |                            |                | #
#                 | |    |            |                         |                            |                | #
#                 | |____|____________|________________________/ \___________________________/                | #
#                 | |    |            |_______________________/\/___________________________/                 | #
#                 | |    |            |                                                                       | #
#                 | |    |            |                            |                                          | #
*                 | |    |            |                            |                                          | #
*                 | |    |            |                                                       (()             | #
*                 | |    |            |                                                      ((  )            | #
*                 | |    |            |                               /\                    ((    )           | #
*                 | |    |            |                    \         /  \                    ((  )            | #
*                 | |    |            |                     \       /    \                    (()             | #
*                 |/\____/____________/                            /      \                                   | #
#                  \/___/____________/                            /        \                                  | #
#                                                                /   TV    /|                                 | #
#                                                        __     /         / |                                 | #
#                                                              /_________/ ||                                 | #
#                                                              |         || |                                 | #
#                                                              |  | | |  | /                                  | #
#                                                              |_________|/                                   | #
#                                                                                                             | #
#                                                                                                             | #
#                                                                                                             | #
#                                                                                                             | #
#                                                                                                             | #
#                                                                                                             | #
#                                                                                                             | #
#                                                                                                             | #
#########################################################*#######################################################