#################################################################################################################
#################################################################################################################
#################################################################################################################
#################################################################################################################
#################################################################################################################
#################################################################################################################
#################################################################################################################
#####################################################################                                          /|
#####################################################################_________________________________________/ |
#####################################################################                                           |
|                                /###################################                                           *
|_______________________________/ ###################################                                           |
|                              |  ###################################                                           |
|                              |  ###################################                                           |
*                              |  ###################################                                           |
|                              |  ###################################                                          /#
|                              |  ###################################                     /######################
|                              |  #########_________*_________#######                    / ######################
|                              | /        /                  /      /                    | ######################
|                              |/________/                  /______/                     | ######################
|                                                                                        | ######################
#############                                                                            | ######################
#############                                                                            | ######################
#############                                                                            | ######################
#############                                                                            | ######################
#############                                                                            | ######################
#############_______________________________________*____________________________________| ######################
#################################################################################################################
#################################################################################################################
#################################################################################################################
#################################################################################################################
#################################################################################################################
#################################################################################################################
#################################################################################################################
