________________________________________________________*________________________________________________________
|                                                                                                               |
|                                                                                                               |
|                                                                                                               |
|                                                                 ;;;;;;;;;;;;;;;;;;;;;;;;;;;;;;;;;;;           |
|                                                                 11111111111111111111111111111111111           |
|                                                                 11111111111111111111111111111111111           |
|             _____________                                       11111111111111111111111111111111111           |
|           /|             |                                      1ooooooooooooooooooooooooooooooooo1           |
|          / |             |                                      11111111111111111111111111111111111           |
|          | |             |                                      1ooooooooooooooooooooooooooooooooo1           |
|          | |             |                                      11111111111111111111111111111111111           |
|          | |             |                                      1ooooooooIoamoaocarpetotoooooooooo1           |
|          | |             |                                      11111111111111111111111111111111111           |
|          | |             |                                      1oooooButotheoASCIIoooartistoisooo1           |
|          | |             |                                      11111111111111111111111111111111111           |
|          | |             |                                      1ooooonotothatogoodooooooooooooooo1           |
|          | |             |                    @                 11111111111111111111111111111111111           |
|          | |             |                    ^                 11111111111111111111111111111111111           |
|          | |             |                                      11111111111111111111111111111111111           |
|          | |             |                                      ;;;;;;;;;;;;;;;;;;;;;;;;;;;;;;;;;;;           |
|          | |             |                                                                                    |
|          | |_____________|                                                                                    |
|          | /            /                                                                                     |
|          |/____________/         _ __ __ _ _ _ ___ __ __ _ __                                                 |
|                                 |                            |                                                |
|                                 |      WELCOME!              |                                                |
|             o   o               |                            | ______________________________________________ |
|              \ /                |          Home is where     |/|  ,.,.,.,.,.,.,.,.,.,.,.,.,.,.,.,.,.,.,.,.,., |
|               X                 |          your spirit is    / |  ;:;:;:;:;:;:;:;:;:;:;:;:;:;:;:;:;:;:;:;:;:; |
|              / \                |     (Yes, I am a carpet)   | |  ;:;:;:;:;:;:;:;:;:;:;:;:;:;:;:;:;:;:;:;:;:; |
|             o   o               |__ __ ____ __ __ __ ___ _ __| |  ;:;:;:;:;:;:;:;:;:;:;:;:;:;:;:;:;:;:;:;:;:; |
|                                                              | |                                              |
________________________________________________*________________________________________________________________
