     /'\_/`\                    
     |     |   _ _  ____    __  
     | (_) | /'_` )(_  ,) /'__`\
     | | | |( (_| | /'/_ (  ___/
     (_) (_)`\__,_)(____)`\____)

+-------------------------------------+
|                                     |
|    READ THE INSTRUCTIONS            |
|                                     |
|    WHEN READY PRESS ANY KEY         |
|                                     |
+-------------------------------------+